##########
#   #    #
### # # ##
# #   #  #
#   @### #
# # #    #
# ##  # ##
#    ##  #
# ##   #+#
##########