##########
#@       #
#        #
#        #
#        #
#        #
#        #
#        #
#       +#
##########