##########
#@#      #
###    # #
#  #     #
#   #    #
#    #   #
#     #  #
###    # #
# #     +#
##########